NO	maps/textures/retro2.xpm
SO	maps/textures/retro.xpm
WE	maps/textures/retro1.xpm
EA	maps/textures/retro3.xpm
SP	maps/tetures/sprite.xpm

F 0,0,25
C 0,0,49




11111111111 1111111111111
10000000001 1000000000001
1011000001111000000000001
1001000000000000000000001
1111111110110000111000001
1000000000110000011101111
1111011111111101110000001
1111011111111101110101001
1100000011010101110002001
1000000000000000110000001
10000000000000001101010N1
1100000111010101111101111
11110111 1110101 10111101
11111111 1111111 11111111

