           NO       ./path_to_the_north_texture          
SO ./path_to_the_south_texture
WE ./path_to_the_west_texture
EA ./path_to_the_east_texture

F  220,100,0
C 225,30,0









11111
11111
11111
11101
11111
11111
11111
11111
11111
11111
11N11
11111
11111
11111
11111
11111
10111
10001
11111
11111
11111
