NO	maps/textures/wall42-2-64x64.xpm
SO	maps/textures/wall42-3-64x64.xpm
WE	maps/textures/wall42-64x64.xpm
EA	maps/textures/wall42-4-64x64.xpm

F 164,225,155
C 70,83,136










        11111111111 1111111111111
        10000000001 1000000000001
        1011000001111000000000001
        10010000000000000000000011111
11111111101100001110000000000001
100000000011000001110111111111110
11110111111111011100000010001
11110111111111011101010010001
11000000110101011100000010001
10000000000000001100000010001
10000000000000001101010W010011
11000001110101011111011100011
11110111 1110101 101111010001
11111111 1111111 111111111111
