           NO       ./path_to_the_north_texture          
SO ./path_to_the_south_texture
WE ./path_to_the_west_texture
EA ./path_to_the_east_texture

F  220,100,0
C 225,30,0





111111111
100000001
101110001
1111010S1
11 111111
