NO	maps/textures/retro2.xpm
SO	maps/textures/retro.xpm
WE	maps/textures/retro1.xpm
EA	maps/textures/retro3.xpm

F 0,0,25
C 0,0,49






        11111111111 1111111111111
        10000000001 1000000000001
        1011000001111000000000001
        10010000000000000000000011111
11111111101100001110000000000001
100000000011000001110111111111110
11110111111111011100000010001
1111012111111101110101001000111
1100000011010101110000001000101
1000000000000000110000001000111
10000000000000001101010N010011
111111111111111111111111111111
